1 1 1 1 1 1 1 1 1 1 1 1 1 1 1 1 1 1 1 1 1 1 1 1 1 1 1 1 1 1 1 1 1 1 1 1 1 1 1 1 1 1 1 1 1 1 1 1 1 1
1 1 1 1 1 1 1 1 1 1 1 1 1 1 1 1 1 1 1 1 1 1 1 1 1 1 1 1 1 1 1 1 1 1 1 1 1 1 1 1 1 1 1 1 1 1 1 1 1 1
1 1 1 1 1 1 1 1 1 1 1 1 1 1 1 1 1 1 1 1 1 1 1 1 1 1 1 1 1 1 1 1 1 1 1 1 1 1 1 1 1 1 1 1 1 1 1 1 1 1
1 1 1 1 1 1 1 1 1 1 1 1 1 1 1 1 1 1 1 1 1 1 1 1 1 1 1 1 1 1 1 1 1 1 1 1 1 1 1 1 1 1 1 1 1 1 1 1 1 1
1 1 1 1 1 1 1 1 1 1 1 1 1 1 1 1 1 1 1 1 1 1 1 1 1 1 1 1 1 1 1 1 1 1 1 1 1 1 1 1 1 1 1 1 1 1 1 1 1 1
1 1 1 1 1 1 1 1 1 1 1 1 1 1 1 1 1 1 1 1 1 1 1 1 1 1 1 1 1 1 1 1 1 1 1 1 1 1 1 1 1 1 1 1 1 1 1 1 1 1
2 2 2 2 2 2 2 2 2 2 2 2 2 2 2 2 2 2 2 2 2 2 2 2 2 2 2 2 2 2 2 2 2 2 2 2 2 2 2 2 3 4 4 4 5 1 1 1 1 1
6 7 8 8 8 8 8 8 8 8 8 8 9 10 11 11 11 12 12 12 12 12 12 12 12 12 13 14 14 14 14 14 14 14 15 12 12 12 12 12 16 17 17 17 18 12 12 12 12 12
19 20 21 22 22 22 22 22 22 22 22 22 23 24 25 26 26 27 27 27 28 29 30 31 27 27 32 33 33 33 33 33 33 33 34 27 27 27 27 27 35 36 37 37 38 27 27 27 27 27
19 39 20 17 17 17 17 17 17 17 17 17 17 40 25 25 25 41 41 41 42 43 44 45 41 41 46 47 48 47 49 47 48 47 50 41 41 41 41 41 51 51 41 41 52 41 41 41 41 41
53 54 39 55 55 55 55 55 55 55 55 56 47 50 25 26 26 57 57 57 57 57 57 57 57 57 58 47 59 47 60 47 59 47 50 57 57 57 57 57 61 62 63 64 65 57 57 57 57 57
53 66 54 55 55 55 55 55 55 55 55 56 47 50 25 25 25 67 67 68 67 67 68 67 67 68 69 70 71 71 71 71 71 71 72 73 67 74 67 67 75 76 77 78 79 68 80 27 27 27
53 66 66 81 82 83 83 83 83 83 83 84 47 50 25 85 25 86 86 87 88 89 87 86 86 87 90 91 17 17 17 17 92 93 17 94 86 87 86 86 95 96 86 97 98 87 99 100 27 27
101 102 66 81 84 103 103 103 103 103 104 84 47 50 26 26 26 105 105 106 105 105 106 105 105 106 107 108 47 47 47 47 109 110 47 50 105 106 105 105 111 112 105 113 114 115 116 117 80 27
118 119 102 81 84 120 120 120 120 120 121 84 47 50 122 122 122 123 124 124 124 125 126 127 128 129 130 131 47 132 47 133 109 134 135 136 118 118 137 118 138 138 118 139 114 118 140 141 142 143
144 145 119 146 147 148 148 148 148 148 149 150 47 50 151 144 144 152 153 144 144 144 144 154 155 156 145 130 47 47 47 47 109 134 157 136 151 144 144 144 158 159 122 160 114 151 145 161 162 163
144 144 145 118 118 118 118 118 118 118 118 118 118 118 164 144 144 144 144 153 144 144 144 144 144 153 145 166 166 166 166 166 166 166 166 164 144 144 144 144 167 118 118 118 164 144 145 168 169
170 170 170 170 170 170 170 170 170 170 170 170 170 170 170 170 170 170 170 170 144 144 144 144 144 171 170 170 170 170 170 170 170 170 170 170 170 170 170 170 170 170 170 170 170 172 173 174 140
175 175 175 175 175 176 176 144 144 144 144 144 144 144 144 144 144 144 144 144 144 144 144 144 144 144 144 144 144 144 144 144 144 144 144 144 144 144 144 144 144 144 144 144 144 144 177 178 179
180 180 180 180 180 181 181 182 182 182 182 182 182 182 182 182 182 182 182 182 182 182 182 182 182 182 183 144 144 144 144 144 144 144 144 144 144 144 144 144 144 144 144 144 144 144 144 184 185
182 182 182 182 182 182 182 182 182 182 182 182 182 182 182 182 182 182 182 182 182 182 182 182 182 182 182 183 144 144 144 144 144 144 144 144 144 144 144 144 144 144 144 144 144 144 144 144 144